{
    "world": [[68, 69, 69, 69, 69, 69, 69, 69, 69, 69, 69, 70], 
              [85, 86, 86, 86, 86, 86, 86, 86, 86, 86, 86, 87], 
              [85, 86, 86, 86, 86, 86, 86, 86, 86, 86, 86, 87], 
              [85, 86, 86, 86, 86, 86, 86, 86, 86, 86, 86, 87], 
              [85, 86, 86, 86, 86, 86, 86, 86, 86, 86, 86, 87], 
              [85, 86, 86, 86, 86, 86, 86, 86, 86, 86, 86, 87], 
              [85, 86, 86, 86, 86, 86, 86, 86, 86, 86, 86, 87], 
              [85, 86, 86, 86, 86, 86, 86, 86, 86, 86, 86, 87], 
              [85, 86, 86, 86, 86, 86, 86, 86, 86, 86, 86, 87], 
              [119, 120, 120, 120, 120, 120, 120, 120, 120, 120, 120, 121]],
    "terrain": [[16, 16, 16, 16, 16, 16, 16, 16, 16, 16, 16, 16],
                [16, 16, 16, 16, 16, 16, 122, 16, 16, 16, 16, 16],
                [16, 16, 16, 105, 16, 16, 16, 16, 106, 16, 16, 16],
                [16, 16, 16, 16, 16, 16, 16, 16, 16, 16, 16, 16],
                [16, 105, 16, 16, 16, 16, 16, 16, 16, 16, 16, 16],
                [16, 16, 16, 122, 16, 123, 16, 16, 16, 16, 105, 16],
                [16, 16, 16, 16, 16, 16, 16, 123, 16, 16, 16, 16],
                [16, 16, 16, 16, 16, 123, 16, 16, 16, 16, 16, 16],
                [16, 16, 16, 16, 16, 16, 16, 16, 16, 123, 16, 16],
                [16, 16, 16, 16, 16, 16, 16, 16, 16, 16, 16, 16]],
    "flags": [{"x" : 1, "y": 1},
              {"x" : 11, "y": 1},             
              {"x" : 1, "y": 9},             
              {"x" : 11, "y": 9}]
}